NO ./texture/TEX1.xpm
SO ./texture/TEX2.xpm
WE ./texture/TEX3.xpm
EA ./texture/TEX4.xpm
F 001,153,100
C 255,255,255

111111111111111111111111111111111
100000000000000000000000111111111
110000000000000000000000111111111
100000000000000000000000111100001
111111111000000000000000000000001
100000000000000000000000000001111
10000000000000N100000000000011111
100000000000000000000000000011111
100000000000000000000000000011111
100000000000000000000000000011111
100000000000000000010100000011111
110000011101010111110111101011111
111101111111011111011110100011111
111111111111111111111111111111111